Abdilazov	Abdykadyr	4
Abdinov	Nurkhan	4
Abdulkareem	Abdulazeem	5
Abdumurodov	Azizbek	2
Abdurakhimov	Abubakrsiddik	3
Adel	Omar	2
Adelosoye	Adeniyi	2
Ahmadov	Elshan	2
Ahmadov	Shukran	4
Ait Moussa	Ahmed	3
Aitanov	Ariet	5
Akgul	Iclal	5
Akmatalieva	Nazbiike	4
Aldabergen	Aigerim	2
Aliyev	Abasgulu	3
Aliyev	Sarkhan	4
Alizada	Khalil	4
Amelchanka	Alesia	5
Amine	Mohamed	3
Andzheychak	Mark	4
Anil Raju	Abhimanyu	3
Anosov	Arsenii	3
Arslan	Sait	4
Artikgaliev	Farokhitdin	4
Assanov	Bereke	5
Aydemir	Halit	5
Aydin	Enes	2
Ayd?n	Betul	5
Aytbaev	Erlan	2
Azamatov	Yryskeldi	3
Bahai	Mikita	3
Bakhtiyorov	Bunyod	5
Baktybek	Gulzina	5
Balaban	Ivan	5
Bassie	Hailegebriel	5
Bastug	Alperen	3
Bautsin	Kirill	2
Baydar	Muhammed	4
Beganov	Asadbek	2
Bely	Aliaksandr	4
Bhandari	Abhishek	5
Bise	Jacob	5
Biswas	Mithun	4
Bobojonov	Salimjon	2
Boltaev	Asadbek	3
Bopape	Katlego	4
Boughalem	Farah	3
Bulakhau	Uladzislau	2
Bunjira	Davison	2
Butko	Volodymyr	3
Chabanets	Nikita	4
Chaitezvi	Dumisani	3
Chaitharin	Chidapha	4
Charowedza	Ruwarashe	3
Charumbira	Praymore	2
Chemugarira	Avante	4
Chen	Zhe	5
Chernetskyi	Roman	2
Chidakuza	Natalie	4
Chidawanyika	Taka	2
Chigumira	Tafadzwa	2
Chikosha	Winstone	2
Chinhamora	Brian	5
Chipanga Junior	Albano	3
Chipise	Tanaka	4
Chirimumimba	Gabriel	3
Chiwara	Michael	3
Choga	Tinotenda	2
Christmas	Manatsaishe	5
Chupryna	Valentyn	5
Chynaliev	Nurtilek	2
Coronado Chichiraky	Sebastian	2
Cumba	Cleide	4
Dalk?ran	Pelin	2
Damirov	Ismayil	2
Davurova	Raniia	3
Do	Dang	2
Dodkhoev	Muhammadosim	5
Domin	Bohdan	4
Duishenbekov	Aidar	4
Dzhumagulov	Rafael	4
Ekekwe	Vincent	2
Erdem	Sena	5
Erdem	Zeynep	2
Erkinov	Amirbek	3
Ernazarov	Ashet	3
Ersan	Sena	5
Fantu	Abenezer	5
Farajzade	Ibrahim	4
Fokin	Illia	2
Gabongwe	Courtney	5
Gadallah	Karem	4
Gandidze	Panashe	2
Ganhairo	Genius	3
Gas?mov	Mammadiyya	5
Gedik	Hayrettin	5
Gojayev	Murad	5
Gonga	Tawana	3
gumbanjera	joey	5
Gündüz	Mehmet	3
Gwati	Brendon	5
Gwiza	Tapiwa	5
Habte	Amanuel	3
Hajili	Rovshan	3
Hnennyi	Illia	5
Horanskyi	Valentyn	2
Hordiienko	Andrii	2
Hossam	Mohamed	3
Hrebeniuk	Maksym	5
Hukallo	Daria	3
Huseynli	Muhammadkadir	4
Huseynli	Rauf	3
Iatsuk	Damir	5
Ibili	Kadir	3
Iksanova	Sabina	5
Ilkhomiddinov	Boburmirzo	2
Imitova	Shakhsanam	2
Ishimwe	Olly	2
Izmalkov	Denys	5
Jasani	Kaushal	5
Jesse	Jeremy	2
Kabaya	Anotida	3
Kadamov	Azizbek	5
Kaddouri	Walid	5
Kagande	Farainesu	4
Kalonga	Jeremiah	4
Kamma	Phani	2
Kangarli	Ulvi	4
Karaagac	Mehmet	4
Karc?	Hamza	2
Karpchenko	Adam	3
Katena	Wesley	5
Keldiyarov	Abbosjon	2
Khakimov	Javokhir	5
Khamroev	Jasurbek	3
Khodjamov	Umidjon	5
Kilic	Efe	5
K?l?c	Ulku	2
Korsun	Maksymilian	3
Kovalov	Oleksandr	3
Kozak	Akram	4
Kuanyshev	Alisher	4
Le	Viet	3
Ledwaba	Ebube	5
Mabhande	Mercy	2
Mabrouk	Mariyam	3
Mafe	Thierry	4
Maiga	Aminata	4
Mandava	Tafadzwa	3
Mandimutsira	Craig	5
Mantsho	Tshego	5
Mapisa	Naison	2
Mapumah	Prince	3
Markeliuk	Tymofii	5
Marocha	Joe	5
Masocha	Dylan	2
Matakanure	Kudzaishe	2
Matekeev	Erpolat	4
Mavhera	Keith	4
Mazivanhanga	Tatenda	5
Meshcheriakova	Myroslava	5
Metmuradov	Harun	2
Mironau	Daniil	2
Mishra	Dhruv	4
Mohamed	Anas	2
Molife	Dumo	5
Mpala	Mbonisi	5
Mpofu	Bakhile	5
Mtetwa	Solomon	3
Mudzingwa	Anesu	3
Mugabe	Stannley	4
Mugagami	Lenin	4
Muktarova	Medine	3
Mukunyadze	Strive	4
Murotov	Shakhzod	5
Murzabekova	Aziza	4
Musariri	Tanaka	5
Musengi	Panashe	3
Mustafazada Asgari	Aydan	4
Muswe	Gladys	5
Mutapanduwa	Taremekedzwa	3
Mutendwa	Panashe	5
Mutunhu	Tariro	4
Muvandi	Takunda	5
Namashamov	Kurmanbek	5
Narbut	Oleh	2
Nasser	Ganna	3
Nguyen	Anh	3
Nhlanhla	Khulekani	3
Niyazov	Daulet	2
Njela	Tapiwanashe	5
Nokutenda  Prince	Mahembe	3
Nopakulwong	Wongsakorn	4
Nuray	Ömer	5
Nurmatov	Baidoolot	3
Nyamayaro	Thomas	5
Nyamkondiwa	Sean	5
Ognianyk	Pavlo	5
Oktay	Halil	3
Omurov	Abdurakhman	3
Onal	Emirhan	5
Ordobaeva	Sapargul	4
Oussama Sallah	Amouri	3
Özbilenler	Asl?han	5
Ozcan	Beng?su	5
Ozen	Sena	4
Ozturk	Enes	5
Pal	Chandroja	5
Parlak	Muhammed	5
Parlak	Rumeysa	3
Pasipamire	Nyasha	4
Pinchuk	Andrei	4
Pliushch	Mykhailo	3
Ponomarenko	Oleksandr	5
Prokopenko	Artur	2
Proskuryakov	Nikita	5
Radoman	Maksim	5
Rahimli	Orkhan	5
Rahman	Fatik	3
Raimberdiyev	Bekbolsun	4
Rakhmanberdiev	Dinislam	5
Ravla	Binita	2
Rudenko	Vladyslav	5
Sadig	Aslan	4
Saizildaeva	Nurella	3
Samir	Mohamed	5
Senturk	Muhammet	2
Shahbazov	Elgun	2
Shakirov	Iskhak	3
Sharma	Sapna	4
Shcherbak	Anatolii	4
Sherif	Mohamed	2
Shinde	Shubhankar	2
Shulhan	Andrii	4
Shumba	Wayne	2
Shynkovich	Yaraslau	4
Sibanda	Makabongwe	4
Sibanda	Thabani	3
Sikirinskyi	Artem	4
Sintsiarou	Uladzislau	3
Skits	Mariia	2
Soluk	Roman	3
Soni	Muffaddal	4
Souhail	Merghich	3
Suleymanov	Mahammad	5
Sultanov	Ernis	5
Svyryd	Danylo	4
Tabra	Hilary	3
Tasci	Mehmet	2
Temerbayev	Adi	2
Thomas	Bijin	5
Tilniak	Nikita	5
Titilayo	Sultan	2
Tkachenko	Yehor	3
Toichubekov	Nurdoolot	4
Tokarenko	Veronika	4
Toksen	Tugba	2
Tomurcuk	Muhammed	4
Toroev	Umar	5
Totskyi	Maksym	2
Tran	Van	3
Traore	Mariam	2
Turganbaev	Nurbek	4
Tymofiichuk	Andrii	5
Unal	Bahtiyar	5
Urumov	Barsbek	2
Usmonov	Khusanjon	3
Vannathan	Abhimanue	4
Velianyk	Oleh	4
Velykholova	Renata	2
Vengesa	Paul	2
Yarina	Violetta	2
Yasar	Ozgenur	3
Yasar	Yahya	2
Yermaganbetov	Bexultan	3
Yetik	Meryem	4
Y?lmaz	Mikdad	3
Y?lmaz	Muhammet	3
Zamirbek	Aiperi	5
Zhalilov	Nurumbet	4
Zhamaitsiak	Daniil	5
Zhenishov	Aziret	5
Zholbolduev	Edil	3
Zhumanaliev	Daler	4
Zhusubaliev	Erkinbek	4
Zhyrnyi	Oleh	5
Zihumo	Munashe	5
Zvobgo	Prince	5
